Nivel 1@15@19@40@40@0@90@40@130@Nivel 1.png@d
b-b-b-b-b-b-b-b-b-b-b-b-b-b-b-b-b-b-b
b-a-a-a-a-a-a-a-a-a-a-a-a-a-a-a-a-a-b
b-a-c-a-c-a-c-a-c-a-c-a-c-a-c-a-c-a-b
b-a-a-a-a-a-a-a-a-a-a-a-a-a-a-a-a-a-b
b-a-c-a-c-a-c-a-c-a-c-a-c-a-c-a-c-a-b
b-a-a-a-a-a-a-a-a-a-a-a-a-a-a-a-a-a-b
b-a-c-a-c-a-c-a-c-a-c-a-c-a-c-a-c-a-b
b-a-a-a-a-a-a-a-a-a-a-a-a-a-a-a-a-a-b
b-a-c-a-c-a-c-a-c-a-c-a-c-a-c-a-c-a-b
b-a-a-a-a-a-a-a-a-a-a-a-a-a-a-a-a-a-b
b-a-c-a-c-a-c-a-c-a-c-a-c-a-c-a-c-a-b
b-a-a-a-a-a-a-a-a-a-a-a-a-a-a-a-a-a-b
b-a-c-a-c-a-c-a-c-a-c-a-c-a-c-a-c-a-b
b-a-a-a-a-a-a-a-a-a-a-a-a-a-a-a-a-a-b
b-b-b-b-b-b-b-b-b-b-b-b-b-b-b-b-b-b-b
Nivel 2@15@19@40@40@0@90@40@130@Nivel 2.png@d
b-b-b-b-b-b-b-b-b-b-b-b-b-b-b-b-b-b-b
b-e-e-e-e-e-e-e-e-e-e-e-e-e-e-e-e-e-b
b-a-c-a-c-a-c-a-c-a-c-a-c-a-c-a-c-a-b
b-a-e-a-e-a-e-a-e-a-e-a-e-a-e-a-e-a-b
b-a-c-a-c-a-c-a-c-a-c-a-c-a-c-a-c-a-b
b-a-e-a-e-a-e-a-e-a-e-a-e-a-e-a-e-a-b
b-a-c-a-c-a-c-a-c-a-c-a-c-a-c-a-c-a-b
b-a-e-a-e-a-e-a-e-a-e-a-e-a-e-a-e-a-b
b-a-c-a-c-a-c-a-c-a-c-a-c-a-c-a-c-a-b
b-a-e-a-e-a-e-a-e-a-e-a-e-a-e-a-e-a-b
b-a-c-a-c-a-c-a-c-a-c-a-c-a-c-a-c-a-b
b-a-e-a-e-a-e-a-e-a-e-a-e-a-e-a-e-a-b
b-a-c-a-c-a-c-a-c-a-c-a-c-a-c-a-c-a-b
b-a-e-a-e-a-e-a-e-a-e-a-e-a-e-a-e-a-b
b-b-b-b-b-b-b-b-b-b-b-b-b-b-b-b-b-b-b
Nivel 3@15@19@40@40@0@90@40@130@Nivel 3.png@d
g-h-h-h-h-h-h-h-h-h-h-h-h-h-h-h-h-h-g
b-a-a-a-a-a-a-a-a-a-a-a-a-a-a-a-a-a-f
b-a-c-a-c-a-c-a-c-a-c-a-c-a-c-a-c-a-f
b-a-a-a-a-a-a-a-a-a-a-a-a-a-a-a-a-a-f
b-a-c-a-c-a-c-a-c-a-c-a-c-a-c-a-c-a-f
b-a-a-a-a-a-a-a-a-a-a-a-a-a-a-a-a-a-f
b-a-c-a-c-a-c-a-c-a-c-a-c-a-c-a-c-a-f
b-a-a-a-a-a-a-a-a-a-a-a-a-a-a-a-a-a-f
b-a-c-a-c-a-c-a-c-a-c-a-c-a-c-a-c-a-f
b-a-a-a-a-a-a-a-a-a-a-a-a-a-a-a-a-a-f
b-a-c-a-c-a-c-a-c-a-c-a-c-a-c-a-c-a-f
b-a-a-a-a-a-a-a-a-a-a-a-a-a-a-a-a-a-f
b-a-c-a-c-a-c-a-c-a-c-a-c-a-c-a-c-a-f
b-a-a-a-a-a-a-a-a-a-a-a-a-a-a-a-a-a-f
g-h-h-h-h-h-h-h-h-h-h-h-h-h-h-h-h-h-g
Nivel 4@15@19@40@40@0@90@40@130@Nivel 4.png@d
h-g-f-g-f-g-f-g-f-g-f-g-f-g-f-g-f-g-o
i-a-a-a-a-a-a-a-a-a-a-a-a-a-a-a-a-a-n
j-a-c-a-c-a-c-a-c-a-c-a-c-a-c-a-c-a-m
k-a-a-a-a-a-a-a-a-a-a-a-a-a-a-a-a-a-p
h-a-c-a-c-a-c-a-c-a-c-a-c-a-c-a-c-a-o
i-a-a-a-a-a-a-a-a-a-a-a-a-a-a-a-a-a-n
j-a-c-a-c-a-c-a-c-a-c-a-c-a-c-a-c-a-m
k-a-a-a-a-a-a-a-a-a-a-a-a-a-a-a-a-a-p
h-a-c-a-c-a-c-a-c-a-c-a-c-a-c-a-c-a-o
i-a-a-a-a-a-a-a-a-a-a-a-a-a-a-a-a-a-n
j-a-c-a-c-a-c-a-c-a-c-a-c-a-c-a-c-a-m
k-a-a-a-a-a-a-a-a-a-a-a-a-a-a-a-a-a-p
h-a-c-a-c-a-c-a-c-a-c-a-c-a-c-a-c-a-o
i-a-a-a-a-a-a-a-a-a-a-a-a-a-a-a-a-a-n
j-l-b-l-b-l-b-l-b-l-b-l-b-l-b-l-b-l-m
Nivel 5@15@19@40@40@0@90@40@130@Nivel 5.png@d
o-h-g-h-g-h-g-h-g-h-g-h-g-h-g-h-g-h-f
j-e-e-e-e-e-e-e-e-e-e-e-e-e-e-e-e-e-l
i-a-c-a-c-a-c-a-c-a-c-a-c-a-c-a-c-a-k
j-a-e-a-e-a-e-a-e-a-e-a-e-a-e-a-e-a-l
i-a-c-a-c-a-c-a-c-a-c-a-c-a-c-a-c-a-k
j-a-e-a-e-a-e-a-e-a-e-a-e-a-e-a-e-a-l
i-a-c-a-c-a-c-a-c-a-c-a-c-a-c-a-c-a-k
j-a-e-a-e-a-e-a-e-a-e-a-e-a-e-a-e-a-l
i-a-c-a-c-a-c-a-c-a-c-a-c-a-c-a-c-a-k
j-a-e-a-e-a-e-a-e-a-e-a-e-a-e-a-e-a-l
i-a-c-a-c-a-c-a-c-a-c-a-c-a-c-a-c-a-k
j-a-e-a-e-a-e-a-e-a-e-a-e-a-e-a-e-a-l
i-a-c-a-c-a-c-a-c-a-c-a-c-a-c-a-c-a-k
j-a-e-a-e-a-e-a-e-a-e-a-e-a-e-a-e-a-l
b-n-m-n-m-n-m-n-m-n-m-n-m-n-m-n-m-n-b
Nivel 6@15@19@40@40@0@90@40@130@Nivel 6.png@d
l-h-h-h-h-h-h-h-h-h-h-h-h-h-h-h-h-h-m
f-a-a-a-a-a-a-a-a-a-a-a-a-a-a-a-a-a-g
f-a-c-a-c-a-c-a-c-a-c-a-c-a-c-a-c-a-g
f-a-a-a-a-a-a-a-a-a-a-a-a-a-a-a-a-a-g
f-a-c-a-c-a-c-a-c-a-c-a-c-a-c-a-c-a-g
f-a-a-a-a-a-a-a-a-a-a-a-a-a-a-a-a-a-g
f-a-c-a-c-a-c-a-c-a-c-a-c-a-c-a-c-a-g
f-a-a-a-a-a-a-a-a-a-a-a-a-a-a-a-a-a-g
f-a-c-a-c-a-c-a-c-a-c-a-c-a-c-a-c-a-g
f-a-a-a-a-a-a-a-a-a-a-a-a-a-a-a-a-a-g
f-a-c-a-c-a-c-a-c-a-c-a-c-a-c-a-c-a-g
f-a-a-a-a-a-a-a-a-a-a-a-a-a-a-a-a-a-g
f-a-c-a-c-a-c-a-c-a-c-a-c-a-c-a-c-a-g
f-a-a-a-a-a-a-a-a-a-a-a-a-a-a-a-a-a-g
k-i-i-i-i-i-i-i-i-i-i-i-i-i-i-i-i-i-j
Nivel 7@15@19@40@40@0@90@40@130@Nivel 7.png@d
b-b-b-b-b-b-b-b-b-b-b-b-b-b-b-b-b-b-b
b-a-a-a-a-a-a-a-a-a-a-a-a-a-a-a-a-a-b
b-a-c-a-c-a-c-a-c-a-c-a-c-a-c-a-c-a-b
b-a-a-a-a-a-a-a-a-a-a-a-a-a-a-a-a-a-b
b-a-c-a-c-a-c-a-c-a-c-a-c-a-c-a-c-a-b
b-a-a-a-a-a-a-a-a-a-a-a-a-a-a-a-a-a-b
b-a-c-a-c-a-c-a-c-a-c-a-c-a-c-a-c-a-b
b-a-a-a-a-a-a-a-a-a-a-a-a-a-a-a-a-a-b
b-a-c-a-c-a-c-a-c-a-c-a-c-a-c-a-c-a-b
b-a-a-a-a-a-a-a-a-a-a-a-a-a-a-a-a-a-b
b-a-c-a-c-a-c-a-c-a-c-a-c-a-c-a-c-a-b
b-a-a-a-a-a-a-a-a-a-a-a-a-a-a-a-a-a-b
b-a-c-a-c-a-c-a-c-a-c-a-c-a-c-a-c-a-b
b-a-a-a-a-a-a-a-a-a-a-a-a-a-a-a-a-a-b
b-b-b-b-b-b-b-b-b-b-b-b-b-b-b-b-b-b-b